"一个人的价值, 在于他贡献了什么, 而不在于他获得了什么!	@爱因斯坦",
"你若喜爱你自己的价值, 你就得给世界创造价值!	@歌德",
"我从来不把安逸和快乐看作是生活目的本身; 	对这种伦理基础, 我称之为[猪栏的理想]	@爱因斯坦",
"未经反思自省的人生不值得去过	The unexamined life is not worth living.	@苏格拉底 (哲学之父)",
"大多数人在20到30岁就已经过完自己的一生; 	一过了这个年龄段, 他们就变成自己的影子, 以后的生命只是在不断重复自己...	@&#12298;约翰.克里斯朵夫&#12299;罗曼.罗兰",
"活着, 如同生命最后一天般活着; 	学习, 如同永远活着般学习!	@圣雄甘地 (印度国父)",
"人所面对的绝境, 在很多情况下都不是生存的绝境, 而是[精神]的绝境!",
"世上只有一种英雄主义 -- 就是在认清生活真相之后依然热爱生活	@罗曼.罗兰",
"人生中最大的两个财富是: 你的才华和你的时间&#12290;	才华越来越多而时间越来越少&#12290;我们的一生就是用时间来换取才华&#12290;",
"Stay hungry. Stay foolish.	@史蒂夫.乔布斯引自&#12298;全球概览&#12299;",
"这辈子没法做太多的事情, 所以每一件都要做到精彩绝伦!	@史蒂夫.乔布斯",
"拥有追随自己内心与直觉的勇气	你的内心与直觉多少已经知道你真正想要成为什么样的人	Have the courage to follow your heart and intuition. They somehow already know what you truly want to become.	@史蒂夫.乔布斯",
"我每天都自问: '如果今天是我生命的最后一天, 我还会做今天打算做的事情吗?'	@史蒂夫.乔布斯",
"时间会刺破青春的华丽精致, 	会把平行线刻上美人的额角, 	会吃掉稀世之珍天生丽质, 	什么都逃不过它横扫的镰刀!	@莎士比亚",
"预测未来最好的方法就是去创造未来	@林肯 (美国前总统)",
"没有人可以回到过去, 重新开始; 	但谁都可以从现在开始, 书写一个全然不同的结局!",
"人的一切痛苦都是源于对自己无能的愤怒	@王小波 (作家)",
"人生最大的痛苦不是失败	而是没有经历自己想要经历的一切",
"许多人所谓的成熟, 不过是被习俗磨去了棱角, 变得世故而实际了; 那不是成熟, 而是精神的早衰和个性的夭亡!	真正的成熟, 应当是独特个性的形成, 真实自我的发现, 精神上的结果和丰收&#12290;	@&#12298;在世纪的转折点上&#12299;尼采(哲学家)",
"你的时间有限, 所以不要浪费时间活在别人的生活里!	Your time is limited, so don't waste it living someone else's life.	@史蒂夫.乔布斯",
"每个人出生的时候都是原创	可悲的是很多人渐渐都成了盗版",
"你若不想做, 总能找到借口	你若想做, 总会找到方法	@阿拉伯谚语",
"想得到你从未拥有过的东西	就必须做你从未做过的事情",
"你若失去了财产, 你只失去了一点儿; 	你若失去了荣誉, 你就失去了许多; 	你若失去了勇气, 你就把一切都失去了!	@歌德",
"那不能杀死我的, 使我更强!	What does not kill me, makes me stronger.	@尼采",
"对爱情的渴望, 对知识的追求, 对人类苦难不可遏制的同情心, 这三种纯洁而无比强烈的激情支配着我的一生&#12290;	Three passions, simple but overwhelmingly strong, have governed my life: the longing for love, the search for knowledge, and unbearable pity for the suffering of mankind.	@&#12298;我为什么而活着&#12299;罗素 (哲学家 数学家 思想家)",
"围在城里的人想逃出来, 城外的人想冲进去; 	对婚姻也罢, 职业也罢, 人生的愿望大都如此!	@&#12298;围城&#12299;钱钟书",
"授人以鱼不如授人以渔!	授人以鱼只救一时之急, 授人以渔则可解一生之需!	(这也是本博客的宗旨)"
"兴趣是最好的老师	@爱因斯坦",
"知识上的投资总能得到最好的回报&#12290;	@本杰明.富兰克林 (美国开国元勋 物理学家 作家)",
"学习不是填满水桶, 而是点燃火焰!	Education is not the filling of a pail but the lighting of a fire.	@叶芝 (爱尔兰诗人)",
"我唯一能确定的就是自己的无知	I know nothing except the fact of my ignorance.	@苏格拉底 (哲学之父)",
"真正的无知不是知识的贫乏	而是拒绝获取知识	@波普尔 (哲学家 思想家)",
"读书是在别人思想的帮助下建立自己的思想	@尼古拉.鲁巴金 (俄国作家)",
"不要盲目地崇拜任何权威	因为你总能找到相反的权威	@罗素 (哲学家 数学家 思想家)",
"不必为自己的独特看法而害怕	因为我们现在所接受的常识都曾是独特看法	@&#12298;自由思想的十诫&#12299;罗素 (哲学家 数学家 思想家)",
"仅仅凭借信仰跟从就等于盲从	To follow by faith alone is to follow blindly.	@本杰明.富兰克林 (美国开国元勋 物理学家 作家)",
"想象力比知识更重要!	因为知识是有限的, 而想象力概括着世界的一切, 推动着进步, 并且是知识进化的源泉	@爱因斯坦",
"要打破人的偏见比崩解一个原子还难!	@爱因斯坦",
"你要按你所想的去生活	否则你迟早会按你所生活的去想",
"大多数人宁愿死去也不愿思考	事实上他们也确实到死都没有思考	@罗素 (哲学家 数学家 思想家)",
"对知识分子而言, 成为思维的精英比成为道德的精英更重要!	@王小波 (作家)",
"只有两样东西可能是无限的 -- 宇宙的大小和人类的愚蠢	不过, 对于前者我不太确定 :-)	@爱因斯坦"
"没有银弹(万能药)	NO silver bullet	@Fred Brooks (图灵奖得主 &#12298;人月神话&#12299;作者)",
"编程的艺术就是处理复杂性的艺术	@Edsger Dijkstra (图灵奖得主)",
"简单即是美	Simple is beautiful",
"简单是可靠的先决条件	Simplicity is prerequisite for reliability.	@Edsger Dijkstra (图灵奖得主)",
"优秀软件的作用是让复杂的东西看起来简单	@Grady Booch (UML 创始人之一)",
"设计软件有两种方法: 一种是简单到极致而明显没有缺陷; 另一种是复杂到极致以至于没有明显的缺陷&#12290;前者要难得多!	There are two ways of constructing a software design: One way is to make it so simple that there are obviously no deficiencies, and the other way is to make it so complicated that there are no obvious deficiencies. The first method is far more difficult.	@C.A.R.Hoare (图灵奖得主 算法大牛)",
"优秀的设计在不断地演化	糟糕的设计在不断地打补丁",
"最纯粹&#12289;最抽象的设计难题就是设计桥梁 -- 你面对的问题是: 如何用最少的材料, 跨越给定的距离&#12290;	@保罗.格雷汉姆 (顶级黑客 硅谷创业教父)",
"从不同的层次审视你的设计",
"在软件[可重用]之前先得[可用]	@Ralph Johnson (设计模式四人帮之一)",
"软件设计就像做爱, 一次犯错, 你要用余下的一生来维护 :-)	@Michael Sinz",
"更好的工具未必能做出更好的设计",
"好的程序员是那种过单行道马路都要往两边看的人	@Doug Linder",
"好的程序代码本身就是最好的文档	@&#12298;代码大全&#12299;Steve McConnell",
"程序必须首先让人类可以理解, 然后顺便让机器能执行&#12290;	@&#12298;SICP&#12299;",
"假如程序代码和注释不一致, 那么很可能两者都是错的!	When code and comments disagree, both are probably wrong.	@Norm Schryer (贝尔实验室科学家)",
"你写下的任何代码, 六个月后再去看, 都像是别人写的 :-)	@Tom Cargill (贝尔实验室科学家)",
"程序员花90%的时间完成90%的代码量, 	但是剩下的10%代码要再花费90%的开发时间 (90-90法则)	@Tom Cargill (贝尔实验室科学家)",
"不能影响你编程观点的语言, 不值得你去学!	@Alan Perlis (第一个图灵奖得主)",
"世界上只有两种编程语言 -- 要么充满了抱怨; 要么没人使用 :-)	@Bjarne Stroustrup (C++ 之父)",
"没有哪种编程语言能阻止程序员写出糟糕的代码, 不管这种语言的结构有多么好!	@Larry Flon",
"C 语言诡异离奇, 缺陷重重, 但却获得了巨大的成功 :-)	@Dennis Ritchie (C 语言之父 Unix 之父)",
"(相对 C 而言)在 C++ 里, 想搬起石头砸自己的脚更为困难了; 	不过一旦你真这么做了, 整条腿都得报销 :-)	@Bjarne Stroustrup (C++之父)",
"Java 与 JavaScript 的关系, 如同雷锋与雷峰塔的关系 :-)",
"在理论上, 理论和实践是没有差异的; 但在实践中, 是有差异的!	In theory, there is no difference between theory and practice. But in practice, there is.	@Snepscheut",
"在进度落后的项目中增加人手只会导致进度更加落后	@Fred Brooks (图灵奖得主 &#12298;人月神话&#12299;作者)",
"用代码行数测算软件开发进度 如同 按重量测算飞机的制造进度	@比尔.盖茨",
"在水上行走和按需求文档开发软件都很容易 -- 前提是它们都处于冻结状态	@Edward V Berard",
"乐观主义是软件开发的职业病	用户反馈则是其治疗方法	@Kent Beck (Extreme Programming 之父)",
"软件开发是一场程序员和上帝的竞赛: 	程序员要开发出更强更好&#12289;连傻瓜都会用的软件; 而上帝在努力创造更傻的傻瓜&#12290;	到目前为止, 一直是上帝赢 :-)	@Rick Cook",
"如果建筑工人像程序员写软件那样盖房子, 那第一只飞来的啄木鸟就能毁掉人类文明 :-)	@Gerald Weinberg (软件工程大牛)",
"如果说调试(debug)是去除 bug 的过程, 那么编程就是制造 bug 的过程&#12290;	@Edsger Dijkstra (图灵奖得主)",
"要在自己的代码里找 bug 是很难的; 	而当你认为你的代码没有错误时, 找 bug 就更难了!	@&#12298;代码大全&#12299;Steve McConnel",
"调试代码比新编写代码更困难; 	因此, 如果你尽自己所能写出了最复杂的代码, 你将没有更大的智慧去调试它 :-)",
"过早的优化是万恶之源	Premature optimization is the root of all evil.	@Donald Knuth (图灵奖得主 算法大牛)",
"Tape is Dead, Disk is Tape, Flash is Disk, RAM Locality is King!	@Jim Gray (图灵奖得主 数据库大牛)",
"软件就像'性' -- 免费的时候更好 :-)	Software is like sex; it's better when it's free.	@Linus Torvalds (Linux 之父)"
"谁控制过去, 谁就控制未来; 	谁控制现在, 谁就控制过去!	Who controls the past controls the future; who controls the present controls the past.	@&#12298;1984&#12299;乔治.奥威尔",
"以铜为镜 可以正衣冠	以史为镜 可以知兴替	以人为镜 可以明得失	@李世民 (唐太宗)",
"人类从历史中学到的唯一教训就是 -- 人类没有从历史中学到任何教训!	@汤因比 (历史学家)",
"人们总以为自己生活的时代糟糕透顶, 总是向往过去的黄金时代; 	但在我们如今认为是身处黄金年代的那些人看来, 他们当时所处的世界同样是苍白无力的!	@伍迪.艾伦 (作家 编剧 导演)",
"管理是一种实践	其本质不在于[知]而在于[行]	其验证不在于[逻辑]而在于[成果]	@彼得.德鲁克 (管理学之父)",
"企业无法持续成长壮大, 反而每况愈下濒临破产的最主要原因是 -- 当企业老板不应该做决策的时候, 却仍然紧握着决策权不放; 	企业应该尽可能将决策权放到最低层级, 越接近行动的现场越好!	@彼得.德鲁克 (管理学之父)",
"管理是一项工作, 但它本身并不是一种全职工作&#12290;	在设计一项管理职务时, 要把'管理'和'工作'(即一个人的'特殊职能'与'本身职务')结合起来&#12290;	一般而言, 管理人员应该既是一个管理人员, 又是一位专业人员&#12290;	@彼得.德鲁克 (管理学之父)",
"用人不在于如何减少人的短处	而在于如何发挥人的长处	@彼得.德鲁克 (管理学之父)",
"企业最大的资产是人	@松下幸之助 (号称日本经营之神)",
"你想雇用的人必须具备3种品质: 正直诚实, 聪明能干, 精力充沛; 	如果缺少第一种, 后两种品质会要你命!	@巴菲特",
"以用户为中心 其它一切纷至沓来	@Google 信条",
"只有偏执狂才能生存	@Andy Grove (英特尔创始人之一, 前任 CEO)",
"我们没有不懂技术的管理人员	因为寻求技术和管理的平衡毫不费力	@比尔.盖茨",
"伟大的车工值得给他几倍于普通车工的薪水; 	但一个伟大的程序员, 其价值相当于普通程序员的1万倍!	@比尔.盖茨",
"我的管理风格既不是美国的个人主义, 也不是日本的共识主义, 而是独特的达尔文主义(适者生存)!	@比尔.盖茨",
"当你用一个手指指着某人时, 请注意其它三个手指在指哪儿	@Gerald Weinberg (软件工程大牛)",
"领袖和跟风者的区别就在于创新	@史蒂夫.乔布斯",
"唯一不变的是变化本身!"
"我也会有恐惧和贪婪, 只不过是 -- 在大众贪婪时恐惧, 在大众恐惧时贪婪!	@巴菲特",
"控制风险的最好办法是深入思考, 而不是投资组合!	@巴菲特",
"价值投资不能保证一定盈利	但价值投资提供了通向成功的[唯一]机会	@巴菲特",
"我从事投资时会观察一家公司的[全貌]	而大多数投资人只盯着它的[股价]	@巴菲特",
"投资成功与否并非取决于你了解的东西, 而在于你能否老老实实地承认你所不知道的东西!	投资人并不需要做对很多事情, 重要的是不要犯重大的错误!	@巴菲特",
"退潮时便可知道谁在裸泳	@巴菲特",
"短期而言, 股票市场是个投票机	长期而言, 股票市场是个称重器	@本杰明.格雷厄姆",
"中国股市比赌场还不如 -- 因为在中国股市, 某些人可以看别人的底牌	@吴敬琏",
"投资是预测资产收益的活动	投机是预测市场心理的活动	@凯恩斯"
"大胆假设	小心求证	@胡适 谈治学",
"合抱之木生于毫末	九层之台起于累土	千里之行始于足下	@&#12298;道德经&#12299;",
"海纳百川 有容乃大	壁立千仞 无欲则刚	@林则徐",
"非淡泊无以明志	非宁静无以致远	@&#12298;淮南子&#12299;刘安",
"获得信任的技巧就是 -- 避免使用任何技巧",
"判断一个人的人品, 不是看他好起来做什么好事, 而是看他坏起来[不做]什么坏事&#12290;",
"不要去欺骗别人 -- 因为你能骗到的, 都是相信你的人",
"不怕神一样的对手	就怕猪一样的队友"